1111111111
1C0P000C01
1000C01111
1E0M00C001
1111111111