11111111111111111
10PE111000C000001
10001110000C00M01
100011100C0001111
10000C00000001001
11111111111111111