11111111111111111111111111111111111111111111111111111111111111111111111111
10000000100000000000100000010000000000000000000000000000000000000000000001
10000000000000000000100000010000000000000011111110000000000000000010000001
10000000100000000000111111110000000000000010000010000000000000000101000001
10000000000000000000000000000000000000000010000010000000000000000010000001
10000000000010000000000000000000000000000010000010000000000000000000000001
11111111111111111111111111111111111111111111111111111111111111111111111111
