1111111111111111111111111111
1000101000000000000000010001
100010100000000000M000000001
1000111000000111100000111001
1000000000000100100000101001
100P000000000100100000111001
1000000000000100100000000001
1111111111111111111111111111	