1111111111111111111111111111
1000101000000000000000010001
1000101000000000000000000001
100*111000000111100000111001
10*1*00000000100100000101001
10*1*E0000000100100000111001
100*000000000100100000000001
1111111111111111111111111111