1111111111111111111111111111
1000101000000000000000010001
1000101000000000000000000001
1000111000000111100000111001
10000000000001001000001E1001
1000000000000100100000111001
1000000000000100100000000001
1111111111111111111111111111	