1111111111111111111111111111
10001010000000000C0000010001
100010100000000000M000000001
1000111000000111100000111001
1000000000C00100100000101001
100P0000000001001000C0111001
100000000000010010E000000001
1111111111111111111111111111