1111111111111111111111111111
1000101000000C00000000010C01
1000101000C00000000000000001
1000111000000111100C00111001
1000000000000100100000101001
100PC000M00001001000C0111001
1000000000000100100E00000001
1111111111111111111111111111