1111111111111111111111111111
1000000000011100000000000001
1000000000010100000000000001
1000000000011100000000000001
10000000000PCE00000000000001
1000000000000000000000000001
1000000000000000000000000001
1111111111111111111111111111