1111111111111111111111111111
1000000000011100000000000001
100000000001P100000000000001
1000000000011100000000000001
100000000000C000000000000001
1000000000000000000000000001
1000000000000000000000000001
1111111111111111111111111111