1111111111111111111111111111
1000101000C00000C000C0010C01
10001010000C000000C000000001
100011100C000111100M00111001
1000000000000100100C00101001
1000C000P0000100100000111001
1C0000000C000100100E0000C001
1111111111111111111111111111