11111111
1C0000z1
1z0C00E1
11111111
