11111111
10000001
1P0000E1
11111111
