11111111
1C0g00z1
1P0C00E1
11111111
