11111111
1C0000z1
1P0C0001
11111111
