11111111
1CE000z1
1P0C00E1
11111111
