1111
1C001001
1P0C10E1
11111111
