11111111
1C0000z1
1P0C0PE1
11111111
