11111111
1C000101
1P0E10C1
11111111