11111111111111111111111111111
10000000010000100000000010001
101000100100000000000000Z0E01
1000P000C00000100000000011111
10100000010000000000z00000001
10000010000000100000000000001
1000z000010000000000001100001
10010000010000100000001100001
10010000010000100000001110001
100100000100001000000011C0001
10010000010000100000001110001
10010000010000100000001100001
1C0000000000000C00000000z0001
11111111111111111111111111111