1111111111111111111111111111111111111111111111111111111111
1000000001000010000000001000110000000010000100000000010001
1010001001000000000000000000110100010010000000000000000001
1000P000C0000010000000001111110000000C00000100000000011111
1010000001000000000000000000110100000010000000000000000001
1000001000000010000000000000000000010000000100000000000001
1000000001000000000000110000110000000010000000000001100001
1001000001000010000000110000110010000010000100000001100001
1001000001000010000000111000110010000010000100000001110001
100100000100001000000011C0001100100000100001000000011C0001
1001000001000010000000111000110010000010000100000001110001
1001000001000010000000110000110010000010000100000001100001
1C0000000000000C00000000000011C0000000000000C0000000000001
1111111111111111111111111111111111111111111101111111111111
1000000001000010000000001000110000000010000100000000010001
10100010010000000000000000E0110100010010000000000000000001
10000000C0000010000000001111110000000C00000100000000011111
1010000001000000000000000000110100000010000000000000000001
1000001000000010000000000000000000010000000100000000000001
1000000001000000000000110000110000000010000000000001100001
1001000001000010000000110000110010000010000100000001100001
1001000001000010000000111000110010000010000100000001110001
100100000100001000000011C0001100100000100001000000011C0001
1001000001000010000000111000110010000010000100000001110001
1001000001000010000000110000110010000010000100000001100001
1C0000000000000C00000000000011C0000000000000C0000000000001
1111111111111111111111111111111111111111111111111111111111