1111111111111111111
1000C000000z00000z1
1P00C0000E00000z001
100000000z000z00001
10000000z00000z0001
1111111111111111111
