1111111111
1z000000C1
100E0000P1
1111111111
