1111111111111111111
1000C000000C00000C1
1P00C0000E00000C001
100000000C000C00001
1CCCCCCCC00000C0001
1111111111111111111
